1111111111
1000000001
1000000001
1P11111E11
1011111111
1111111111
