11111
100C1
10001
1P111
11001
111E1
11111
