1111111
1000001
1P111111
1E11111
10CCC11
1111111
