1111111111111111111
1000000000000000001
10E0111011111000001
100C100011111000001
1011100011111000001
1C00100CP1111000001
1111101111111000001
11111011111110C0001
1111100000000000001
1111111111111110001
1111111111111111111
