1111111111111
10010000000C1
1000011111001
1P0011E000001
1000000001011
1111110011011
1C00111C10001
1000000011C11
1111111111111
