1111111
1P00001
10000C1
1000001
10000E1
1111111
